46
a a a a a a a a a a a a a a a a
a a a a a a a a a a a a a a a a
a a a a a a a a a a a a a a a a
a a a a a a a a a a a a a a a a
a a a a a a a a a a a a a a a a
a a a a a a a a a a a a a a a a
a a a a a b b b b a a a a a a a
b a a a b b a a a a a a a a a a
b b b b b a a a a a a a a a a a
b b b b a a a a a a a a a a a a
b b b a a a a a a a a a a a a a
b b a a a a a a a a a a a a a a
b a a a a a a a a a a a a a a a
a a a a a a a a a a a x a a a a
a a a a a a a a a a b y a b a a
a a a a a a a a a a b b b b a a
a a x a a a a a a a a a a a x a
a a a a a a a a a a a a a a a a
a a x a a a a a a a a a a a a a
a a a a a a a a a a a a a a a a
a a x a a a a a a a a a a a a a
a a a a a a a a a a a a a a a a
a a x a a a a a a a a a a a a a
a a a a a a a a a a a a a a a a
a a a a a a a a a a a a a a a a
a a a a a y a a a a a a a a a a
b b b b b b a a b b b b b b b b
a a a a a a a a a a a a a a a a
a b b b b b b a a a a a a a a a
x b b b b a a a b a a a a x a a
a b b b a a a a a b a a a a a a
a b b a a a a a a b b a a a a a
x b a a x a a a a a b b a a a a
a b a a a a a a a a a b b a a a
a a a a b a a a a a a a b b a a
b b b b b a a a a a a a a a a a
a a a a a a a a a a a a a b b b
a a a a a a a a a a a a a a a a
a a a a a a a a x a a a b b b x
a a a a a a a a b a a a a a a a
a a a a a a a a b b a a a b b b
a a a a a a a a b b b a a a a a
a a a a a a a a b b b b a a a x
a a a a a a a a b a x b b b b b
a x a a a a a a a a a a a a a b
a y a b a b a b a b a b a a z b