29
a a a a a a a a a a a a a a a a
a a a a a a a a a a a a a a a a
a a a a a a a a a a a a a a a a
a a a a a a a a a a a a a a a a
a a a a a a a a a a a a a a a a
a a a a a a a a a a a a a a a a
a d a a a a a a a a a a a a a a
a a a a a a a a a x a a a a a a
a a a a a a a b a a a a a a a a
a a a a a a b b a a a a a a a a
b b b b b b b b b b a a a b b b
a a a a a a a a a a a a a a x b
a a a a x a a x a a a a a b b b
a a a x a a b b b b a a b b b b
a a a a a a a a a a a b b b b b
a a a a a a a a a a b b b b b b
a a b b b b b b b b b b b b b b
a a b b b a a a a a a a a a a a
a a b b a a a a a a a a a a a a
a a b a a x a a a a a a a a a a
a a a a a a a a a a a a a a a a
a a a a b a a b a a a a a a a a
a a a b b a a b b a a a a a a a
a a b b b b b b b b b b b b a a
a a a a a a a a a a a a a a a a
a a a a a a a a a a a a a a a a
a a a a a a a a a a a a a a a a
a a a a a a a a a a a a a a a a
a z a a a a a a a a a a a a a a